"filename", "language", "C++", "comment", "blank", "total"
"/home/tanlam/dev/phd/research/2021/2021-09b/dctc/include/data_structures/counter.h", "C++", 1, 0, 0, 1
"/home/tanlam/dev/phd/research/2021/2021-09b/dctc/include/dctc/algorithms/connectivity/relays/relays_utils.h", "C++", 2, 0, 0, 2
"/home/tanlam/dev/phd/research/2021/2021-09b/dctc/include/dctc/algorithms/connectivity/relays/simple_relays_alg.h", "C++", 7, 0, 2, 9
"/home/tanlam/dev/phd/research/2021/2021-09b/dctc/include/dctc/instance/instance.h", "C++", 2, 0, 0, 2
"/home/tanlam/dev/phd/research/2021/2021-09b/dctc/include/dctc/network_components/graphs/MST_graph.h", "C++", 2, 0, 0, 2
"/home/tanlam/dev/phd/research/2021/2021-09b/dctc/include/dctc/network_components/nodes/node.h", "C++", 1, 0, 0, 1
"/home/tanlam/dev/phd/research/2021/2021-09b/dctc/include/dctc/utils.h", "C++", 2, 0, 1, 3
"/home/tanlam/dev/phd/research/2021/2021-09b/dctc/include/dctc/utils.tpp", "C++", 8, 0, 1, 9
"/home/tanlam/dev/phd/research/2021/2021-09b/dctc/src/data_structures/counter.cpp", "C++", 1, 0, 1, 2
"/home/tanlam/dev/phd/research/2021/2021-09b/dctc/src/dctc/algorithms/connectivity/relays/relays_utils.cpp", "C++", 18, -1, 2, 19
"/home/tanlam/dev/phd/research/2021/2021-09b/dctc/src/dctc/algorithms/connectivity/relays/simple_relays_alg.cpp", "C++", 17, -3, -1, 13
"/home/tanlam/dev/phd/research/2021/2021-09b/dctc/src/dctc/instance/instance.cpp", "C++", 3, -1, 1, 3
"/home/tanlam/dev/phd/research/2021/2021-09b/dctc/src/dctc/network_components/graphs/MST_graph.cpp", "C++", 12, 5, 2, 19
"/home/tanlam/dev/phd/research/2021/2021-09b/dctc/src/dctc/network_components/nodes/MST_node.cpp", "C++", 3, 0, 0, 3
"/home/tanlam/dev/phd/research/2021/2021-09b/dctc/test/src/dctc/algorithms/connectivity/relays/test_relays_utils.cpp", "C++", 23, 0, 6, 29
"/home/tanlam/dev/phd/research/2021/2021-09b/dctc/test/src/dctc/algorithms/connectivity/relays/test_simple_relays_alg.cpp", "C++", 49, 0, 8, 57
"Total", "-", 151, 0, 23, 174