"filename", "language", "C++", "comment", "blank", "total"
"/home/tanlam/dev/phd/research/2021/2021-09b/dctc/include/dctc/algorithms/connectivity/Lam/long_edge_first_relays_alg.h", "C++", 3, 0, 0, 3
"/home/tanlam/dev/phd/research/2021/2021-09b/dctc/include/dctc/algorithms/connectivity/Lam/long_short_edge_relays_alg.h", "C++", 1, 0, 0, 1
"/home/tanlam/dev/phd/research/2021/2021-09b/dctc/include/dctc/algorithms/connectivity/relays/simple_relays_alg.h", "C++", 3, 0, 0, 3
"/home/tanlam/dev/phd/research/2021/2021-09b/dctc/include/dctc/network_components/graphs/MST_graph.h", "C++", 4, 0, 2, 6
"/home/tanlam/dev/phd/research/2021/2021-09b/dctc/src/dctc/algorithms/connectivity/Aschner/MST_graph_Aschner.cpp", "C++", 1, 0, 0, 1
"/home/tanlam/dev/phd/research/2021/2021-09b/dctc/src/dctc/algorithms/connectivity/Lam/MST_node_Lam.cpp", "C++", 1, 0, 0, 1
"/home/tanlam/dev/phd/research/2021/2021-09b/dctc/src/dctc/algorithms/connectivity/Lam/long_edge_first_relays_alg.cpp", "C++", 60, -1, 6, 65
"/home/tanlam/dev/phd/research/2021/2021-09b/dctc/src/dctc/algorithms/connectivity/Lam/long_short_edge_relays_alg.cpp", "C++", 7, 0, 0, 7
"/home/tanlam/dev/phd/research/2021/2021-09b/dctc/src/dctc/algorithms/connectivity/Tran/MST_graph_Tran.cpp", "C++", 1, 0, 0, 1
"/home/tanlam/dev/phd/research/2021/2021-09b/dctc/src/dctc/algorithms/connectivity/relays/relays_MST_graph.cpp", "C++", 1, -1, 0, 0
"/home/tanlam/dev/phd/research/2021/2021-09b/dctc/src/dctc/algorithms/connectivity/relays/relays_utils.cpp", "C++", 0, 6, 2, 8
"/home/tanlam/dev/phd/research/2021/2021-09b/dctc/src/dctc/algorithms/connectivity/relays/simple_relays_alg.cpp", "C++", 21, 0, 0, 21
"/home/tanlam/dev/phd/research/2021/2021-09b/dctc/src/dctc/network_components/graphs/MST_graph.cpp", "C++", 12, 0, 3, 15
"/home/tanlam/dev/phd/research/2021/2021-09b/dctc/test/src/dctc/algorithms/connectivity/relays/test_relays_MST_graph_Aschner.cpp", "C++", 6, 0, 2, 8
"/home/tanlam/dev/phd/research/2021/2021-09b/dctc/test/src/dctc/algorithms/connectivity/relays/test_relays_MST_graph_Aschner_Tran_Lam.cpp", "C++", 98, 5, 14, 117
"/home/tanlam/dev/phd/research/2021/2021-09b/dctc/test/src/dctc/algorithms/connectivity/relays/test_relays_MST_graph_Aschner_and_Tran.cpp", "C++", 0, 2, 0, 2
"/home/tanlam/dev/phd/research/2021/2021-09b/dctc/test/src/dctc/algorithms/connectivity/relays/test_relays_MST_graph_Aschner_and_Tran_1.cpp", "C++", 0, 2, 0, 2
"/home/tanlam/dev/phd/research/2021/2021-09b/dctc/test/src/dctc/algorithms/connectivity/relays/test_relays_MST_graph_Lam.cpp", "C++", 84, 16, 17, 117
"/home/tanlam/dev/phd/research/2021/2021-09b/dctc/test/src/dctc/algorithms/connectivity/relays/test_relays_MST_graph_Tran.cpp", "C++", 5, 0, 2, 7
"/home/tanlam/dev/phd/research/2021/2021-09b/dctc/test/src/dctc/algorithms/connectivity/relays/test_relays_utils.cpp", "C++", 7, 0, 1, 8
"Total", "-", 315, 29, 49, 393