"filename", "language", "C++", "comment", "blank", "total"
"/home/tanlam/dev/phd/research/2021/2021-09b/dctc/include/dctc/algorithms/connectivity/Aschner/MST_graph_Aschner.h", "C++", 17, 0, 6, 23
"/home/tanlam/dev/phd/research/2021/2021-09b/dctc/include/dctc/algorithms/connectivity/Tran/MST_graph_Tran.h", "C++", -1, 0, 0, -1
"/home/tanlam/dev/phd/research/2021/2021-09b/dctc/include/dctc/network_components/graphs/MST_graph.h", "C++", 3, 0, 0, 3
"/home/tanlam/dev/phd/research/2021/2021-09b/dctc/src/dctc/algorithms/connectivity/Aschner/MST_graph_Aschner.cpp", "C++", 121, 12, 16, 149
"/home/tanlam/dev/phd/research/2021/2021-09b/dctc/src/dctc/algorithms/connectivity/Tran/MST_graph_Tran.cpp", "C++", -4, 0, -1, -5
"/home/tanlam/dev/phd/research/2021/2021-09b/dctc/src/dctc/algorithms/connectivity/relays/relays_MST_graph.cpp", "C++", -1, 1, 0, 0
"/home/tanlam/dev/phd/research/2021/2021-09b/dctc/src/dctc/network_components/graphs/MST_graph.cpp", "C++", 20, -6, 3, 17
"/home/tanlam/dev/phd/research/2021/2021-09b/dctc/test/src/dctc/algorithms/connectivity/Aschner/test_MST_graph_Aschner.cpp", "C++", 87, 0, 15, 102
"/home/tanlam/dev/phd/research/2021/2021-09b/dctc/test/src/dctc/algorithms/connectivity/relays/test_relay_MST_graph_Tran.cpp", "C++", -83, -1, -15, -99
"/home/tanlam/dev/phd/research/2021/2021-09b/dctc/test/src/dctc/algorithms/connectivity/relays/test_relays_MST_graph_Aschner.cpp", "C++", 93, 4, 14, 111
"/home/tanlam/dev/phd/research/2021/2021-09b/dctc/test/src/dctc/algorithms/connectivity/relays/test_relays_MST_graph_Aschner_and_Tran.cpp", "C++", 57, 0, 9, 66
"/home/tanlam/dev/phd/research/2021/2021-09b/dctc/test/src/dctc/algorithms/connectivity/relays/test_relays_MST_graph_Tran.cpp", "C++", 93, 4, 14, 111
"Total", "-", 402, 14, 61, 477